XXXXXXXXXXXXXXXX
XXXXXXXOOXXXXXXX
XXOXXX     OXXXX
XS   X OXO XXXXX
XXOO O XXX XXXXX
XXXX   OXX OXXXX
XXXXOXXXXO    CX
XXXXXXXXXXXOOXXX
XXXXXXXXXXXXXXXX
