XXXOOXXXXOXXOXXX
X              X
X OXXXOXXXOOXO X
X XX     XXXOX X
X OX OOX XX    O
X    XXO XX OXOX
XXOOXXXX XX  CXX
XS       OXOOXXX
XXXXXOXXOXXXXXXX
