XXXXXXXXXXXXXXXX
XS  X   X   OXXX
XXO X O X O XXXX
XXX X X X X XXXX
XXO X X X X X CX
XXO X X X X X XX
XXX O X O X O XX
XXX   X   X   OX
XXXXXXXXXXXXXOXX
